R 600 400
NO ./textures/redbrick.xpm
SO ./textures/bookshelf.xpm
WE ./textures/greybrick.xpm
EA ./textures/colorstone.xpm

S ./textures/key.xpm
F 70,255,70
C 209,224,224

        1111111111111111111111111
        1000000000110000000000001
        1011000001110000002000001
        1001000000200000000200001
111111111011020001110000002000001
100020000011000001110111111111111
11110111111111011100000010001
11110111111111011101010010001
11000000110101011100000010201
10002W00200000001100000010201
10000200000000001101010010201
1122000111010101111101111010111
11110111 1110101 101111010001
11111111 1111111 111111111111
