R 2500 2000
R 500 500
C 255 255 100

F 200 10 200

NO ./path1
SO ./path2

WE ./path3
EA ./path4

S ./path5

1     11111
  1101
1S10 1
10     1
10      1
1111111
