R 10000 10000

C 255 255 100

F 200 10 200

NO ./path1

SO ./path2

WE ./path3
EA ./path4

S ./path5

      111
     12W21
    1020001
    1000001
    1000001
    1200021
     12021
     10001
     12021
     10001                                1111111
 111112021111111111111111111           1110000000111
10000000000000000000000000001        11000000000000011
10020000000000000000000000111       1000000000000000001
10000000000000000000000000000111111100000000000000000001
 11110000000000001111110000000000000000000000000000000001
    1000000000001   1000000000000000000000000000000000001
    1000000000001   100000000111111100000000000000000001
    10000000000001111000000111      1000000000000000001
 111000000000000000000000001         11000000000000011
1000000000000000100000111111           1110000000111
1000000111110000000001                    1100001
1000001     100000001       111111111111111100001
1000001     100000001       100000000000000000001
 11111       1111111        111111111111111111111
 
 
 
1111111
1010101
1111111
